1111111111111111111111111111
1001000N000C0000000000000001
100001111100CCCCCCC000000001
1P0011E00000NNE0000000001111
1111111111111111111111111111