11111111111
100000000P1
1000000EN00
10000C00001
11111111111