1111111111111
1C010000000C1
1000000000001
100011E000001
100000000P001
10C0000000001
100000C000N01
1111111111111