11111111111
100000000P1
1000000EN01
10000000001
11111111111