11111111111
100000000P1
10N0E01
10000C00001
11111111111